hits: {
      job: 'Вакансия',
      company: 'Компания',
      remarks: 'Примечания',
      sent: 'Подано',
      seen: 'Просмотрено',
      closed: 'Закрыта',
      no: 'Нет',
      none: 'Не подано ни на одну должность. Чтобы подать резюме кликните "Подать резюме" на карточке вакансии',
    },
    jobsList: {
      zero: 'Нет ни одной вакансии',
      zerozero1: 'По запросу',
      zerozero2: 'ничего не найдено',
    },
    sub: {
      navCV: 'Резюме',
      navSentCVs: 'Поданные резюме',
      navPersonal: 'Личные данные',
      navSettings: 'Настройки',
      cvurlUploaded: 'Резюме не загружено',
      cvurlNone: 'Резюме загружено',
      loadCVHeader: 'Загрузить резюме',
      deleteCVBtn: 'Удалить резюме',
      name: 'Имя',
      surname: 'Фамилия',
      change: 'Изменить',
      email: 'Email',
      oldPW: 'Старый пароль',
      newPW: 'Новый пароль',
      dataChanged: 'Данные изменены',
      dataError: 'Ошибка при изменении данных',
      cvDeleted: 'Резюме удалено',
      cvTooBig: 'Резюме больше 100кб',
      wrongData: 'Неправильные данные',
      pwChanged: 'Пароль изменен'
    },
    upl: {
      header: 'Добавление нескольких вакансий',
      stepAdd: 'Добавить несколько вакансий через Excel',
      chooseFile: 'Выберите файл с вакансиями.',
      fileExample: 'Пример файла',
      stepPublish: 'Опубликовать вакансии',
      tdTilte: 'Название',
      tdSalMin: 'Зарп от',
      tdSalMax: 'Зарп до',
      tdCurr: 'Вал юта',
      tdAgeFrom: 'возр от',
      tdAgeTo: 'возр до',
      tdTimeFrom: 'время от',
      tdTimeTo: 'время до',
      tdSchedule: 'режим',
      tdLangs: 'Языки',
      tdEdu: 'Образ ование',
      tdExp: 'Стаж',
      tdCity: 'Город',
      tdJTyp: 'Тип занят ости',
      tdMore: 'Дополнительно',
      tdTel: 'Тел',
      tdMail: 'Почта',
      reset: 'Сбросить',
      publish: 'Опубликовать',
      stepFinish: 'Финиш',
      addMore: 'Добавить еще несколько вакансий через Excel',
      allPublishedHeader: 'Все опубликованные вакансии',
      authPlsMsg: 'Авторизируйтесь, для возможности загрузки вакансий',
      success1: 'Вакансии добавлены, они будут доступны для всех после проверки модератором',
      err1: 'Загрузка не удалась',
      readyToUpload: 'готов к загрузке',
      getData: 'Загрузите данные',
      perm: 'постоянная',
      temp: 'временная',
    },