fb: {
      topic: 'Тема',
      yourname: 'Ваше имя',
      yourname: 'Ваше имя',
      hyphenMail: '* Email',
      mailValReq: 'Обязательное поле',
      mailValFormat: 'Некорректный формат адреса',
      textLabel: 'Пожелания',
      btnSend: 'Отправить',
      btnSendMore: 'Отправить еще',
      toMain: 'На главную',
      messageSuccess: 'Успешно отправлено',
      messageError: 'Ошибка на сервере'
    },
    companyPage: {
      categoriesHeader: 'Сферы деятельности компании',
      descHeader: 'Описание',
      publishedJobsCountLabel: 'Размещено вакансий: ',
      registrationDate: 'Зарегистрирована: ',
    },
    jobPage: {
      jobClosed: 'Вакансия закрыта',
      reason: 'причина',
      sendCV: 'Подать резюме',
      cvAlreadySent: 'Резюме уже подано',
      reqs: 'Требования',
      none: 'Не указаны',
      expNone: 'Без опыта.',
      exp1_3: 'Опыт: от 1 до 3 лет.',
      exp3_5: 'Опыт: от 3 до 5 лет.',
      exp5_: 'Опыт: от 5 лет.',
      ageLabel: 'Возраст:',
      from: 'от',
      to: 'до',
      years: 'лет',
      eduLabel: 'Образование:',
      langsLabel: 'Языки:',
      conds: 'Условия работы',
      salLabel: 'Оклад:',
      from2: 'с',
      schedule: 'График работы:',
      jTypeLabel: 'Вакансия',
      jTypePermanent: 'постоянная',
      jTypeTemporary: 'временная',
      desc: 'Описание',
      contacts: 'Контакты',
      publishedDate: 'Дата публикации:',
      salaryNone: 'по итогам собеседования',
    },