entProfile: {
      navPublishedLabel: 'Вакансии',
      navResponsesLabel: 'Отклики',
      navAboutLabel: 'О компании',
      navSettingsLabel: 'Настройки',
      publishedHeader: 'Опубликованные вакансии',
      cvSent: 'Подано:',
      cvSeen: 'Просмотрено:',
      cvNotSeen: 'Просмотрено: нет',
      cname: 'Название компании',
      dragLogo: 'Загрузка логотипа компании (Перетяните)',
      sitePH: 'Сайт',
      catPH: 'Сфера деятельности',
      descPH: 'Описание',
      sendChanges: 'Отправить изменения',
      settingsLabel: 'Компания',
      emailLabel: 'Email',
      oldPWLabel: 'Старый пароль',
      newPWLabel: 'Новый пароль',
      changeSettingsBtn: 'Изменить',
      companyDomains: ["Автомобильный бизнес", "Гостиницы, рестораны, общепит, кейтеринг", "Государственные организации", "Добывающая отрасль", "ЖКХ", "Информационные технологии, системная интеграция, интернет", "Искусство, культура", "Лесная промышленность, деревообработка", "Медицина, фармацевтика, аптеки", "Металлургия, металлообработка", "Нефть и газ", "Образовательные учреждения", "Общественная деятельность, партии, благотворительность, НКО", "Перевозки, логистика, склад, ВЭД", "Продукты питания", "Промышленное оборудование, техника, станки и комплектующие", "Розничная торговля", "СМИ, маркетинг, реклама, BTL, PR, дизайн", "Сельское хозяйство", "Строительство, эксплуатация, проектирование", "Недвижимость", "Телекоммуникации, связь", "Товары народного потребления (непищевые)", "Тяжелое машиностроение", "Управление многопрофильными активами", "Услуги для бизнеса", "Услуги для населения", "Финансовый сектор", "Химическое производство, удобрения", "Электроника, приборостроение, бытовая техника, компьютеры и оргтехника", "Энергетика"],
      pwChanged: 'Пароль изменен',
      pwWrongData: 'Неправильные данные',
      dataChanged: 'Данные изменены',
      dataError: 'Ошибка',
      picLoaded: 'Изображение загружено',
      picTooBig: 'Картинка больше 400кб'
    },
    jobsStats: {
      title: 'Название',
      views: 'Всего просмотров',
      uniqViews: 'Уникальных просмотров',
      change: 'Изменить',
      close: 'Закрыть',
      delete: 'Удалить',
      closed: 'Закрыта',
      none: 'Нет ни одной вакансии',
    }